111
11
11
0
0
0
000000000S
0
0
000WWWWWWW
000W00000W
000W00000W
000W00000W
000W00000W
000W00000W
000WWW0WWW