111
1S
000Q
0
000
0
0
0000000000T
0
000WWWWWWW
000W000000
000W00000W
000W000000
000W00000W
000W000000
000WWW0WWW