0
0
0
0
0
0
0
0
0
000WWWWWWW
000W00000W
000W00000W
000W00S00W
000W00000W
000W00000W
000WWWWWWW